Step	d00	d11	w00	Pir0	Pir1	Pir2	Siren	Central
0		1	1	1	1	1	1	0		0
1		1	1	1	1	1	1	0		1
2		1	1	1	1	1	1	0		1
3		1	1	1	1	1	1	0		1
4		1	1	1	1	1	1	0		1
5		1	1	1	1	1	1	0		1
6		1	1	1	1	1	1	0		1
7		1	1	1	1	1	1	0		1
8		1	1	1	1	1	1	0		1
9		1	1	1	0	1	1	1		1
10		1	1	1	0	1	1	1		1
11		1	1	1	0	1	1	1		1
